R 1920 1080

NO ./path_to_the_north_texture

SO ./path_to_the_south_texture
WE ./path_to_the_west_texture
EA ./path_to_the_east_texture
S  ./path_to_the_sprite_texture



F 220,100,0
C 225,255,255

1111111111111111111111111111111111111
1000000000000001000100000000000000001
1000000000000000101100000010000000001
1000000000000000000000000010000000001
1000000000000110000000000011111111111
1000000000000000000000000000000000001
1000000000000000000000000011111111111
100000000000000100000000001
100000000000000100000000011
111111111111111111111111111
