R 1920 1080
NO gheoghegeoghoe
SO ehrgoegheog
WE egrjpgjephg
EA egrkprghjerhpjeh

S gjpephjsth
F 123, 124, 230 
C 10, 01, 98

111111111111111111111111111
100000000000000000000000001
100000000000000000000000001
100000000000000000000000001
100000000000000000000000001
100000000000000000000000001
100000000000000000000000001
100000000000000000000000001
100000000000000000000000001
111111111111111111111111111